**XXXXXXXXXXXXXXXXXXXX
X*X*******************
X*X*X**XX**XXXX*XXXX**
X***X***********X*****
X*XXXXX*X*X*X*X*X*XXXX
X***X*****X***X*X*****
X***XXX*X*XXXXXXXXXXXX
X*X*****X*************
XXXXX*XXXX*X*XXXXXX***